........W...W.......
.X....W...W...W....R
####^^^^^^^^^^^^^^..
.......W...W...W....
r....W...W...W...W..
..^^^^^^^^^^^^^^^^##
....W...W...W.......
..W...W...W...W....R
##^^^^^^^^^^^^^^^^..
.......W...W...W....
r....W...W...W...W..
..^^^^^^^^^^^^^^^^##
...W...W...W...W....
.W...W...W...W....1.
####################
Red tiles are hot and reduce the time before you explode.
40